111111111111111111111111111111111111111111111111111111111111111111111111111111111111111111111111111111
111111111111111111111111111111111111111111111111111111111111111111111111111111111111111111111111111111
111111111111111111111111111111111111111111111111111111111111111111111111111111511111111111111111111111
111111111111111111111111111111111111111111111111111111111111111111111111111111111111111111111111111511
111111111111111111111111111111111111111111111111111111111511111111111111111111111111111111111111111111
111111111111111111111111111111111111111111111111111111111111111111111111111111111111111111111111111111
111111111111111111111111111111111111111111111111111115111111111111151111111111111111111111111111111111
111111111111111111111111111111111111111111111111111111111111511111111111111111111111111111111111111111
111111111111111111111111111111111111111111111111111111111111111111111111111111111111111111111111111111
111111111111111111111111111111111111111111111111111111151111111111111151111111111151111111115111111111
111111111111111111111111111111111111111111111111111511111111111111111111111111111111111111111111111111
111111111111111111111111111111111111111111111151111111111111111111111111111111511111111111111111111111
111111111111111111111111111111111111111511111111111111111111111111151111111111111111111111111111111111
111111111111111111111111111111111111111111111111111111111111151111111111111111111111151111111111111111
111111111111111111111111111111111111111111111111111111111111111111111111111111111111111111111111111111
111111111111111111111111111111111111111111111111111111111111111111111111151111111111111111111111111111
111111111111111111111111111111151111111111111115115111151111151111111111111111111111111111111111111111
111111111111111111111111111111111111111111111111111111111111111111111111111111111111111111111111111111
111111111111111111111111111111111111111111111111111111111111111111111111111111111511111111111111111111
111111111111111111111111151111111111115111111115115111151111111111151111111111111111111111111111111111
111111111111111111111111111111111111111111111111111111111111111111111111111111111111111111111111111111
111111111111111111111111111111111111111111111111111111111111111111111111111111111111111111111111111111
111111111111111111111111111111151111111111111111111111111111111111111111111111111111111111111111111111
111111111111111111111111111111111111111111111111115111151111151111111111111151111111111111111111111511
111111111111111111111111111111111111111111111111111111111111111115111111111111111111111111111111111111
111111111111111111111111111111111111111111111111111111111111111111111111111111111111111111111111111111
111111111111111111111111111111111111111111111111111111111111111111111111111111111111111111111111111111
111111111111111111111111111111111111111111111111111111111111111111111111151111111511111111111111111111
111111111511111111111111111111111111111111111111111111111111111115111111111111111115151111111111111111
111111111111111111111111151111111111111111111111111111111111111111111111111111111111111111111111111111
111111111111111111111111111111511111111111111111111111111111111111111111111111111111111111111111111111
111111111111111111111111111111111111111111111111111111111111111111115111111111111111111111111111111111
111111111111111111111111111111111111111111111111111111111111111111111111111111111111111111111111111111
111111111111111111111111111111111111111111111111111111111111111111111111111111111111111111111111111111
111111111111111111111111151111111111111111111111111111111111111115111111111111111511111111111111111111
111111111111111111111111111111511111111111111111111111111111111111111111111111111115151151111111111111
111111111111111111111111111111111111111111111111111111111111111111111111111111111111111111111111111111
111111111111111111111111111111111111111111111111111111111111111111111111111111111111111111111111111111
111111111111111111111111151111111111111111111111111111111111111111111111111111111111111111111111111111
111111111111511111111111111111111111111111111111111111111111115111111115111111111111111111111111111111
111111111111111111111111111111111511111111111111111111111111111111111111111111111111111111111111111111
111111111111111111111111111111111111111111111111511111111111111111111111111111111111111111111111111111
111111111111111111111111111111111111111111111111111111151115111111511111111111111111111111111111111111
111111111111111111111111111111111111111111111111111111111111111111111111111111111111111111111111111111
111111111111111111111111111111111111111111111111111111111111111111111111111111111111111111111111111111
111111111111111111111111111111511511111111111111511111111111111511111111111111111111111111111111111511
111111111111111111111111111111111111111111111111111115111511111111111111111111111111111111111111111111
111111111111111111111111111111111111111111111111111111111111111111115111111111111111111111111111111111
111111111111111111111111111111111111111111111111111111111111151111111111111111111111111111111111111111
111111111111111111111111111111111111111111111111111111111111111111111111111151111111111111111111111111
111111111111111151111111511111115111111111111115111111111111111111111111111111111151111111111111111111
111111111111111111111111111111111111111111111111111511111111111111111111111111111111111111111111111111
111111511111111111111111111111111111111511111111111111111111111111111111111111111111111111111111111111
111111111111111111111111111111111111111111111111111111111111111111111111111111111111111111111111111111
111111111111111111111111111111111111111111111111111111111111111115111111111511111511111111111111151111
111111111111111111111111111111111111111511111115111111111111111111111111111111111111111111111111111111
111111111111111111111111111111111111111111111111115111111111111111151111111111111111111111111111111111
111111111111111111111111111111111111151111111111111111511111111111111111115111111111111111111111111111
111111111111111111111111111111111511111111111111111111111111111111111111111111111111111111111111111111
111111111111111115111111151111111111111111111111111111111111111111111111111111111111111111111111111111
111111111111111111111111111111111111111111111111111111111111111111111111111111111111111111111111111111
111111111111111111111111111111111111111111111111111111111111111111111111111111111111111111111111111111
111111111111111111111111111111111111111111111111111111111151111111111111111111111111111111111111111111
111111111111111111111111111111111111111111111111111511111111115111511111111115111111111111111111111111
111111111111111111111111111111111111111111111111111111111111111111111111111111111111111111111111111111
111111111111111111111111111111111111111111511111111111111111111111111111111111111111111111111111111111
111111111111111111111111111111111111111111111111111111115111111111111111111111111111111111111111111111
111111111111111111111111111111111111151111111111111111111111511111111111111111111111111111111111111111
111111111111111111111111151111111111111111111111111111111111111511111151111111151111111111111111111111
111111111111111111111111111111111111111111115111115111111111111111111111111111111111111111111111111111
111111111111111111111111111111111111111111111111111111111111111111111111111111111111111111111111111111
111111111111111111111111111111111111111111111111111111111111111111111111111111111111111111111111111111
111111111111111111111111111111111111111111111111111111111111111111111111111111111111111111111111111111
111111111111111111111111111111111111111111111111111111111111111111111111111111111111111111111111111111
111111111111111111111111111111111111111111111111115111115111511111111111111111111111111111111111111111
111111111111111111111111111111111111151111111111111111111111111111151111111111111111111111111111111111
111111111111111111111111151111111111111111111111111111111111111111111111111111111111111111111111111111
111111111111111111111111111111111111111111111111111111111111111111111111111111111111111111111111111111
111111111111111111111111111111111111111111111111111111111111111111111111111111111111111111111111111111
111111111111111111111111111111111111111151151115115111111111111111111111111511111111111111111111111111
111111111111111111111111111111111111111111111111111111111111111111111111111111111111111111111111111111
111111111111111111111111111111111111111111111111111111111111511111111111111111111111111111111111111111
111111111111111111111111115115111115111111111111111111111111111111111111111111111111111111111111111111
111111111111111111111111111111111111111111111111111111111111111111111111111111111111111111111111111111
111111111111111111111151111111111111515151151115111111111111111111111111111111111111111111111111111111
111111111111111111111111111115111111111111111111115111111111111111111111111111111111111111111111111111
111111111111111111111111111111111111111511111111111111111111111111111111111511111111111111111111111111
111111111111111111111111111111111111111111111111111111111111111111111111111111111111111111111111111111
111111111111111111111111111111111111111111111111111111111111111111111111111111111111111111111111111111
111111111111111111111111151111111111111111111111111111111111111111111111111111111111111111111111111111
111111111111111111111111111111111111111111111111111111111111111111111111111111111111111111111111111111
144444444444444444444444444444444444444444444444444444444444444444444444444444444444444444444444444441
144444444444444444444444444444444444444444444444444444444444444444444444444444444444444444444444444441
144444444444444444444444444444444444444444444444444444444444444444444444444444444444444444444444444441
144444444444444444444444444444444444444444444444444444444444444444444444444444444444444444444444444441
144444444444444444444444444444444444444444444444444444444444444444444444444444444444444444444444444441
144444444444444444444444444444444444444444444444444444444444444444444444444444444444444444444444444441
144444444444444444444444444444444444444444444444444444444444444444444444444444444444444444444444444441
144444444444444444444444444444444444444444444444444444444444444444444444444444444444444444444444444441
144444444444444444444444444444444444444444444444444444444444444444444444444444444444444444444444444441
144444444444444444444444444444444444444444444444444444444444444444444444444444444444444444444444444441
111111111111111111111111111111111111111111111111111111111111111111111111111111111111111111111111111111