No  Node1 Node2 type valid 
0   0     2     1    1
1   0     1     1    1
2   1     3     1    1
3   1     4     1    1
4   1     5     1    1
5   2     4     1    1
6   3     4     1    1
7   3     5     1    1