111111111
118811111
118811111
111111111
111111111
111111151
111111111
111111111
151111111
111111111
