111111111111
151111111151
111111111111
111111111111
111188811111
111188811111
111188811111
111188811111
111188811111
111188811111
151111111151
111111111111