1111111
1511151
1111111
1181111
1181111
1511151
1111111